N
15
G
15
D
50,50
C
10
S
17,37
1,19
47,28
16,48
50,26
50,23
22,11
10,42
37,27
28,11
30,8
3,35
21,32
28,7
9,1
P
21,25
8,34
1,6
48,49
2,25
44,13
42,41
32,1
19,46
35,19
32,13
29,50
43,15
35,18
13,41
F
5,27
41,37
8,22
18,24
9,29
35,24
14,29
13,16
46,45
40,47
9,26
32,46
34,20
38,41
31,5
M
1,1,1,1,50,1,1,1,1,1,1,1,1,1,1,1,1,1,1,1,1,1,50,1,1,1,1,1,1,1,1,1,1,1,1,1,1,1,1,1,1,1,1,1,1,1,1,1,1,1
1,1,1,1,1,1,1,50,1,1,1,1,1,50,1,1,1,1,1,50,50,1,1,1,1,1,1,1,1,1,1,1,1,1,50,1,1,1,1,1,1,1,1,1,1,1,1,1,1,1
1,50,1,1,1,1,1,1,1,50,1,1,1,50,1,1,1,1,1,1,1,50,1,1,1,1,1,1,1,1,1,1,1,1,1,1,50,1,1,1,1,1,1,1,1,1,1,1,1,1
1,1,1,1,1,1,1,1,1,1,1,1,1,1,1,1,1,1,1,1,1,1,1,1,1,1,1,1,1,1,1,50,1,1,1,1,1,1,1,1,1,1,1,50,1,1,1,1,1,1
1,1,1,1,1,1,50,1,1,1,1,1,1,1,1,1,1,50,1,1,1,1,1,1,1,1,1,1,1,1,1,1,1,1,1,1,1,1,1,1,1,1,1,1,1,1,1,1,1,1
1,1,1,50,1,1,1,1,1,1,1,50,1,1,1,1,1,1,1,1,50,1,1,1,1,1,1,1,1,1,1,1,1,1,1,1,50,1,1,1,1,1,1,1,1,1,50,1,1,1
1,1,1,1,50,1,1,50,1,1,1,1,1,1,50,1,1,1,1,1,1,1,1,1,1,1,1,1,1,1,1,1,1,50,1,1,1,1,1,50,1,1,1,50,1,1,1,1,1,1
1,1,1,50,1,1,1,1,1,1,50,1,1,1,1,1,50,1,1,1,1,1,1,1,1,1,1,1,1,1,1,1,1,1,50,1,1,1,1,1,1,1,1,1,1,1,1,1,1,1
1,1,1,50,1,50,1,50,1,1,50,1,1,1,1,1,1,50,1,50,1,1,1,50,50,1,1,1,1,1,1,1,1,50,50,1,1,1,1,1,1,1,1,1,1,50,1,1,1,1
1,1,1,1,1,1,1,50,50,50,1,1,1,1,1,1,1,1,1,1,1,1,1,1,1,1,1,50,1,1,1,1,1,1,1,50,1,1,1,1,1,1,1,1,1,1,1,1,1,50
1,1,1,1,1,1,1,1,1,1,1,1,1,1,1,1,1,1,1,1,1,50,1,1,1,1,50,1,1,1,1,1,50,50,1,1,1,1,1,1,1,1,50,1,1,1,1,1,1,1
1,1,1,1,1,50,1,1,1,1,1,1,1,1,1,1,50,1,1,1,1,1,1,1,1,1,1,1,1,1,1,1,1,1,1,1,1,1,1,1,1,1,1,50,1,1,1,1,1,1
1,1,1,1,1,1,1,1,1,50,1,1,1,1,1,1,1,1,1,1,1,50,1,1,1,1,1,1,1,1,1,1,50,1,1,1,1,1,1,1,1,1,1,1,50,1,1,1,1,1
1,1,1,1,1,1,1,1,1,1,50,1,1,1,1,1,1,1,1,1,50,1,1,1,1,1,1,1,1,1,1,1,1,1,50,1,1,50,1,1,1,1,1,50,1,1,1,1,1,1
1,1,1,1,1,1,1,1,50,1,50,1,1,50,1,50,1,1,1,1,1,1,1,1,1,50,1,1,1,1,1,1,1,1,1,1,1,1,1,1,1,1,1,1,1,1,1,1,1,50
1,1,1,1,1,1,1,1,1,1,1,1,1,1,50,1,1,1,50,1,1,1,1,1,1,1,1,1,1,1,1,1,1,1,50,1,1,1,50,50,1,1,1,1,1,1,1,1,1,1
1,50,1,1,1,1,1,1,1,1,1,1,1,1,1,1,1,1,1,1,1,1,1,1,1,1,1,1,1,1,1,1,1,1,1,1,1,1,1,50,1,1,1,1,1,1,1,1,50,1
1,1,1,1,1,1,1,1,1,1,1,1,1,1,1,1,1,1,50,1,1,1,1,1,1,1,1,50,50,1,1,1,1,1,1,1,1,1,1,1,1,50,1,1,50,1,1,1,1,1
1,50,1,50,1,1,1,1,1,50,1,1,1,1,1,1,1,1,1,1,1,1,1,1,1,1,1,1,1,1,1,1,50,1,1,1,1,1,1,1,1,1,1,1,1,1,50,1,1,1
1,1,1,1,1,1,1,1,1,1,1,50,1,1,1,1,1,1,1,1,1,1,1,1,1,1,1,1,1,1,1,1,1,1,1,1,1,1,1,1,1,1,1,1,1,1,1,1,1,1
1,1,1,1,1,1,1,1,50,1,1,1,1,1,1,1,1,1,1,1,1,1,1,1,1,1,1,1,1,50,50,1,1,1,50,1,50,1,1,1,1,1,1,1,1,1,1,1,50,1
50,1,1,1,1,1,1,1,1,1,1,1,1,1,1,1,1,1,1,1,1,1,1,1,1,1,1,1,1,1,1,1,1,1,1,1,1,1,1,1,1,1,1,1,1,1,50,1,1,50
1,50,1,1,1,1,1,1,1,50,50,1,50,1,1,1,1,1,50,1,1,1,1,1,50,1,1,1,1,1,1,1,1,1,1,50,1,1,1,1,1,1,1,1,1,1,1,1,1,1
1,1,1,1,1,1,1,1,1,1,1,1,1,1,50,1,1,1,1,1,1,1,1,1,50,1,50,1,50,1,1,1,1,1,1,1,1,1,1,1,1,1,50,1,1,50,1,1,1,1
50,1,1,1,1,1,1,1,1,1,1,1,1,1,1,1,1,1,1,1,1,50,1,1,1,1,1,1,1,1,50,1,1,1,1,1,1,1,1,1,1,1,1,50,1,1,1,1,1,1
1,1,1,1,1,1,1,1,1,50,1,1,1,1,1,1,50,1,1,1,1,1,50,1,1,1,50,1,1,1,1,1,1,1,1,1,50,1,1,1,1,1,1,1,1,1,1,1,1,1
1,1,50,1,50,1,1,1,1,1,50,1,1,1,1,1,1,1,1,1,1,1,1,1,1,50,1,1,1,1,1,1,1,1,1,1,50,1,1,50,1,1,1,1,1,1,1,1,1,1
1,1,1,1,1,1,1,1,1,1,1,50,1,1,1,50,1,1,1,1,1,1,1,1,1,1,1,1,1,1,1,1,1,1,50,50,1,1,1,1,1,1,1,1,1,1,1,50,1,1
1,1,1,1,1,1,1,1,1,1,1,1,1,1,50,1,1,1,1,1,50,1,1,1,1,1,1,1,1,1,1,1,1,1,1,1,1,1,1,1,1,1,1,1,50,1,1,1,1,1
1,1,1,50,1,1,1,1,1,1,1,1,1,1,1,1,1,1,1,1,1,1,1,1,1,1,1,1,1,1,1,1,1,1,1,1,1,1,1,1,50,1,50,1,50,1,1,50,50,1
1,1,50,1,1,1,1,1,50,50,50,1,1,1,1,1,1,1,1,1,1,1,1,1,1,1,1,1,1,1,1,1,1,1,1,1,1,1,1,1,50,1,1,1,1,1,1,1,1,1
1,1,1,50,1,1,1,1,1,1,1,1,1,1,1,1,1,1,1,1,1,50,1,1,1,1,1,1,1,1,1,1,1,1,1,1,50,1,1,50,1,1,1,1,1,1,1,1,1,1
1,1,50,1,1,1,1,1,1,1,1,1,1,1,1,1,1,1,1,1,1,1,1,1,1,1,1,1,50,1,1,1,1,1,1,50,1,1,1,1,50,1,1,1,1,1,1,1,1,1
1,1,1,1,1,1,1,50,1,1,1,1,1,1,1,1,1,1,1,1,50,1,1,1,1,1,1,1,50,1,1,1,1,1,1,1,1,1,50,1,1,1,1,1,1,1,1,1,1,1
1,1,1,1,1,1,1,1,1,1,1,1,1,1,1,1,1,1,1,1,1,1,1,1,1,1,1,1,1,1,1,1,1,50,1,1,50,1,1,1,1,1,1,1,1,1,1,1,1,1
1,1,1,1,1,1,1,1,1,1,1,1,1,1,1,1,1,1,1,1,1,1,1,1,1,1,1,1,50,1,1,1,1,1,1,1,1,1,50,1,1,50,1,1,1,1,1,1,1,50
1,1,1,1,1,1,1,1,1,1,50,1,1,1,1,1,1,1,1,50,1,1,1,1,1,1,1,1,1,50,1,1,1,1,1,1,50,1,1,1,1,1,1,1,1,50,1,1,1,1
1,50,1,50,1,1,1,50,1,1,1,1,50,1,1,1,1,1,1,1,1,50,50,1,1,1,1,1,1,1,50,1,1,1,1,1,1,1,1,1,1,1,1,1,1,1,1,1,1,1
1,1,1,1,1,1,1,1,1,1,1,1,1,1,50,1,1,1,1,1,1,1,1,1,50,1,1,1,1,1,1,1,1,1,1,1,1,1,50,1,50,1,1,1,1,1,1,50,50,50
1,1,1,1,1,50,50,1,1,50,1,1,1,1,1,1,1,1,1,1,1,1,50,1,1,1,1,1,1,1,1,1,1,1,1,1,1,1,1,1,1,1,1,1,50,1,1,1,1,1
1,1,1,1,1,1,1,1,1,1,1,1,1,1,1,1,1,1,1,1,1,1,50,1,1,1,1,1,1,1,50,1,1,1,50,1,1,1,1,1,1,1,1,1,1,1,1,1,1,1
1,1,50,1,1,1,50,1,1,1,1,1,1,1,1,1,1,50,1,1,1,1,1,1,1,50,1,1,1,1,1,1,1,1,50,1,1,1,1,1,1,1,1,1,1,1,1,1,1,1
1,1,50,1,50,1,1,1,1,1,1,1,1,1,1,1,1,1,1,1,1,1,1,1,1,1,1,1,1,1,1,1,50,1,1,1,1,1,1,1,1,50,1,1,1,50,1,1,1,1
1,1,1,1,50,1,1,1,1,1,1,1,1,1,1,1,1,1,1,1,1,1,1,1,50,50,50,1,50,1,1,1,1,1,1,1,1,1,1,1,1,1,1,1,1,1,50,1,1,1
1,1,1,1,1,1,1,1,1,1,50,50,1,1,1,1,1,1,1,1,1,1,1,1,50,1,1,1,1,1,1,1,1,1,50,1,1,50,50,1,1,50,1,1,1,50,1,1,1,1
1,1,1,1,1,1,1,50,1,50,1,1,50,1,1,1,1,1,1,1,50,1,1,1,1,1,1,1,1,1,1,1,50,1,50,1,1,1,1,1,1,1,50,1,1,1,1,1,1,1
1,1,1,1,50,50,1,1,1,1,1,1,1,1,1,1,1,1,1,1,1,1,1,1,1,1,1,1,1,50,1,1,1,1,1,1,1,1,1,50,1,1,1,1,1,1,1,1,1,1
1,1,1,1,1,1,1,1,1,1,50,1,1,1,50,1,1,1,1,1,1,1,1,1,1,1,1,1,1,1,1,1,1,1,1,50,1,1,1,1,1,1,1,1,1,1,1,50,1,1
1,1,1,1,1,50,1,1,1,1,1,1,1,1,1,1,1,1,1,50,1,50,1,1,1,1,1,1,50,50,50,1,1,1,1,1,1,1,1,1,50,1,50,1,1,1,1,1,1,1
1,1,1,1,50,1,1,1,1,1,1,1,1,1,1,1,1,1,1,1,1,1,1,1,1,1,1,1,1,1,50,1,1,1,1,1,1,1,1,1,50,1,1,1,1,50,1,1,1,1